1111111111111111111
10000000000000000E1
1000000000000000001
100000000000000C001
1000000000000000001
10000000000C0000001
10000000000C0000001
10000000000C0000001
100000000P000000011
1000000000000000001
10000C0C000000000E1
1111111111111111111
